111111111111111111111111111111111
1P0000000000000000000000000000001
101111111111111111111111111111101
1010000000C0000000C0000000C000001
101011111010111110101111101011101
101010001010100010101000101010101
101010101010101010101010101010101
1000C010100C010100C010100C0100C01
101010101010101010101010101010101
101010001010100010101000101010101
101011111010111110101111101011101
1010000000C0000000C0000000C000001
101111111111111111111111111111101
1000000000000000000000000000000E1
111111111111111111111111111111111